X XXXXXXXXXXXXXXXXXX
X XXXXX XXXXXXXXXXXX
X XXXXX XXXXXXXXXXXX
X       XXXXXXXXXXXX
XXXXXXX XXXXXXXXXXXX
XXXXXXX XXXXXXXXXXXX
XXXXXXX XXXXXXXXXXXX
XXXXXXX XXXXXXXXXXXX
XXXX    XXXXXXXXXXXX
XXXXXXX XXXX XXXXXXX
XXXXXXX XXXX XXXXXXX
XXXXXXX XXXX        
XXXXXXX XXXX XXXXXXX
XXXX    XXXX XXXXXXX
XXXXXXX XXXX XXXXXXX
XXXXXXX XXXX XXXXXXX
XXXXXXX XXXX XXXXXXX
XXXXXXX      XXXXXXX
XXXXXXXXXXXXXXXXXXXX
XXXXXXXXXXXXXXXXXXXX
