XXXXXXXXXX XXXXXXXXX
XXXXXXXXXX XXXXXXXXX
XXXXXXXXXX XXXXXXXXX
XXXXXXXXXX XXXXXXXXX
XXXXXXXXXX XXXXXXXXX
XXXXXXXXXX XXXXXXXXX
XXXXXXXXXX XXXXXXXXX
XXXXXXXXXX XXXXXXXXX
XXXXXXXXXX XXXXXXXXX
XXXXXXXXXX XXXXXXXXX
XXXXXXXXXX    XXXXXX
XXXXXXXXXX XX       
XXXXXXXXXX XXXXXXXXX
XXXXXXXXXX XXXXXXXXX
XXXXXXXXXX XXXXXXXXX
XXXXXXXXXX XXXXXXXXX
XXXXXXXXXX XXXXXXXXX
XXXXXXXXXX XXXXXXXXX
XXXXXXXXXX XXXXXXXXX
XXXXXXXXXXXXXXXXXXXX