X XXXXXXXXXXXXXXXXXXXXXXXXXXXXXXXXXXXXXXXXXXXXXXXXXXXXXXXXXXX
X X     X   X     X     X X     X   X           X   X       X
X X XXX X X X XXXXX X X X X XXXXXXX X X XXX X X X X X XXXXXXX
X   X X X X X X     X X   X   X X X   X   X X X   X   X X   X
XXXXX X XXX X XXX XXXXX XXXXX X X XXX XXXXXXXXXXX X XXX X XXX
X   X       X X X X X   X     X             X X   X       X X
XXX X XXXXX X X X X XXX X XXX XXX XXXXX XXX X XXX X X XXXXX X
X       X             X X X   X X X X   X     X   X X X     X
X X X X XXXXX X XXX X X XXX XXX XXX X XXX XXXXX XXXXX X XXXXX
X X X X     X X X   X X X X   X X X     X X X   X X X X     X
X XXX XXX X XXX X XXXXX X X XXX X X XXXXXXX X XXX X XXX XXX X
X   X X   X X   X X   X X X X     X   X X       X       X   X
XXXXX XXXXXXXXX X X X XXX X XXXXX XXX X XXX XXX XXXXXXX XXXXX
X X   X X X   X X X X   X   X     X     X     X X     X     X
X X XXX X XXX X XXXXX X X X X XXX XXX X XXX XXX X XXX X XXX X
X     X       X X     X X X   X       X X X   X     X   X   X
XXX X XXXXX X X X X X XXX X XXXXXXX X X X XXXXX X X XXXXX XXX
X   X   X   X   X X X     X X     X X X X   X   X X X X X   X
X XXXXX X XXX X XXX X XXX XXX XXXXXXXXXXXXX X XXX XXX X XXX X
X   X   X X   X   X X X       X X     X       X X X       X X
XXXXX XXXXXXX XXX X X XXX X XXX X X X X XXX X X XXX XXXXX X X
X   X X     X X     X X   X X     X X   X   X X X       X   X
XXX X XXX X X X XXXXXXX XXX XXX X X XXXXXXX XXX X XXXXXXX X X
X X   X   X X X X         X   X X X X X X   X X X   X X   X X
X X XXXXX XXX XXXXX X X XXXXX XXX XXX X XXX X X X XXX X X XXX
X   X   X X   X   X X X     X X   X     X X X         X X   X
X XXX XXX XXXXXXX XXXXXXXXX XXXXXXXXXXX X XXXXXXXXX X XXXXX X
X   X X       X       X   X         X   X   X     X X     X X
X X X X XXXXXXX XXX XXX X XXXXXXX XXXXX X XXXXX XXXXX XXXXXXX
X X           X   X   X X     X           X   X X         X X
XXX XXXXX X XXX X XXXXXXXXX XXX XXXXXXXXXXX XXX XXXXXXX XXX X
X   X     X X   X X   X       X X         X     X   X   X   X
X X XXXXXXX XXX XXX XXXXXXXXX X XXXXXXX X X X XXXXX XXXXXXX X
X X   X X X X     X X X       X         X X X   X X         X
XXXXXXX X XXXXX XXX X X XXX XXX XXXXXXX XXXXX X X XXX XXXXX X
X     X X X X X       X X           X X       X     X X   X X
XXX XXX X X X X XXX XXXXX XXX X X XXX XXX XXXXX X X XXX X X X
X X             X X X X   X X X X X X   X     X X X     X   X
X XXXXXXXXX XXXXX X X XXX X XXX XXX XXX XXXXX XXXXXXX XXXXX X
X     X     X   X     X     X   X X     X   X     X     X   X
XXXXX X XXX XXX XXX XXX XXX XXXXX XXXXX X XXXXXXXXXXX XXX X X
X     X X         X     X X X     X   X X         X     X X X
XXX XXXXXXXXXXX XXXXX XXX X XXX XXX X X X XXXXXXX XXXXXXXXXXX
X   X   X       X     X X X         X X   X X   X   X     X X
X X X XXXXX X XXX X X X X X X XXX XXXXX XXX X XXX XXXXXXX X X
X X X X   X X   X X X X     X X X   X   X   X   X       X   X
X X X X XXX X XXX XXX XXXXXXX X XXXXXXXXX XXX X X XXXXXXXXX X
X X X     X X   X X     X X X X     X X       X       X X X X
XXX X X X XXX X XXXXX XXX X XXXXXXX X XXX XXXXXXXXXXX X X X X
X     X X     X   X X X X X   X   X   X   X     X X X     X X
X X XXXXXXX XXXXX X X X X XXX X XXXXX X X X XXXXX X X X X X X
X X   X X X   X   X       X     X       X     X X X   X X   X
X XXX X X XXXXX XXXXXXX XXXXX X XXXXX X XXX XXX X XXXXX XXXXX
X X     X X X X   X   X X     X   X   X   X X   X X     X   X
XXX X X X X X XXXXX X X XXXXX X XXXXXXXXX XXX X X XXX X XXX X
X X X X           X X X   X   X X X X   X   X X       X X   X
X X X XXXXX X X XXX XXX X XXX XXX X X XXX X X X X XXXXXXXXX X
X X X X   X X X   X   X X X X X X   X     X X X X X   X X   X
X X XXXXX X XXXXXXX X X X X X X X XXXXXXXXX X XXX XXX X XXX X
X   X           X   X   X                   X X              
XXXXXXXXXXXXXXXXXXXXXXXXXXXXXXXXXXXXXXXXXXXXXXXXXXXXXXXXXXXXX
